#################
#A      #       #
# ###### # #### #
# #           # #
# # ######### # #
# #           # #
# # ######### # #
# #           # #
# # ######### # #
# #           # #
# # ######### # #
# #           # #
# ########### # #
#             #B#
#################
